......M.....{.......
.....MMM....{.......
....................
...P.....P.....P....
..WWW...WWW...WWW...
...P.....P.....P....
....................
....................
....................
...W...........W....
..PWP.........PWP...
...W...........W....
....................
....................
....................
...P.....P.....P....
..WWW...WWW...WWW...
...P.....P.....P....
....................
....................